NO ./assets/wolfenstein/brick.xpm
SO ./assets/wolfenstein/stone.xpm
WE ./assets/wolfenstein/cave.xpm
EA ./assets/wolfenstein/wood.xpm

S ./assets/wolfenstein/guard.xpm

F 112,112,112
C 56,56,56

111     1111111111111111111111111   
101     100000000110000000000011
111     1011000001110000000200001
        1001000000000000000000001
111111111011000001110000000000001
100000000011000001110111111111111
11110111111111011100000010001
11110111111111011101010000201
110000001101010111000000000011111
100020000000000011000000000000001
100000000000000011010100100011111
11000001110101011111011110N01
11110111 1110101 101111010001
11111111 1111111 111111111111
