
NO ./assets/wolfenstein/wood.xpm
SO ./assets/wolfenstein/door.xpm
EA ./assets/wolfenstein/brick.xpm
WE ./assets/wolfenstein/cave.xpm

C 055,200,160
F 122,122,122

11111111111111111
10000000000000001
10000000000000001
10000000000000001
10000000000000001
10000000W00000001
10000000S00000001
10000000000000001
10000000000000001
10000000000000001
10000000000000001
10000000000000001
11111111111111111
